ADD: 'ADD';
AFTER: 'AFTER';
ALL: 'ALL';
ALTER: 'ALTER';
ALWAYS: 'ALWAYS';
ANALYZE: 'ANALYZE';
AND: 'AND';
ANTI: 'ANTI';
ANY: 'ANY';
ANY_VALUE: 'ANY_VALUE';
ARCHIVE: 'ARCHIVE';
ARRAY: 'ARRAY';
AS: 'AS';
ASC: 'ASC';
AT: 'AT';
AUTHORIZATION: 'AUTHORIZATION';
BETWEEN: 'BETWEEN';
BOTH: 'BOTH';
BUCKET: 'BUCKET';
BUCKETS: 'BUCKETS';
BY: 'BY';
CACHE: 'CACHE';
CASCADE: 'CASCADE';
CASE: 'CASE';
CAST: 'CAST';
CATALOG: 'CATALOG';
CATALOGS: 'CATALOGS';
CHANGE: 'CHANGE';
CHECK: 'CHECK';
CLEAR: 'CLEAR';
CLUSTER: 'CLUSTER';
CLUSTERED: 'CLUSTERED';
CODEGEN: 'CODEGEN';
COLLATE: 'COLLATE';
COLLECTION: 'COLLECTION';
COLUMN: 'COLUMN';
COLUMNS: 'COLUMNS';
COMMENT: 'COMMENT';
COMMIT: 'COMMIT';
COMPACT: 'COMPACT';
COMPACTIONS: 'COMPACTIONS';
COMPUTE: 'COMPUTE';
CONCATENATE: 'CONCATENATE';
CONSTRAINT: 'CONSTRAINT';
COST: 'COST';
CREATE: 'CREATE';
CROSS: 'CROSS';
CUBE: 'CUBE';
CURRENT: 'CURRENT';
CURRENT_DATE: 'CURRENT_DATE';
CURRENT_TIME: 'CURRENT_TIME';
CURRENT_TIMESTAMP: 'CURRENT_TIMESTAMP';
CURRENT_USER: 'CURRENT_USER';
DAY: 'DAY';
DAYS: 'DAYS';
DAYOFYEAR: 'DAYOFYEAR';
DATA: 'DATA';
DATABASE: 'DATABASE';
DATABASES: 'DATABASES';
DATEADD: 'DATEADD';
DATEDIFF: 'DATEDIFF';
DBPROPERTIES: 'DBPROPERTIES';
DEFAULT: 'DEFAULT';
DEFINED: 'DEFINED';
DELETE: 'DELETE';
DELIMITED: 'DELIMITED';
DESC: 'DESC';
DESCRIBE: 'DESCRIBE';
DFS: 'DFS';
DIRECTORIES: 'DIRECTORIES';
DIRECTORY: 'DIRECTORY';
DISTINCT: 'DISTINCT';
DISTRIBUTE: 'DISTRIBUTE';
DIV: 'DIV';
DROP: 'DROP';
ELSE: 'ELSE';
END: 'END';
ESCAPE: 'ESCAPE';
ESCAPED: 'ESCAPED';
EXCEPT: 'EXCEPT';
EXCHANGE: 'EXCHANGE';
EXCLUDE: 'EXCLUDE';
EXISTS: 'EXISTS';
EXPLAIN: 'EXPLAIN';
EXPORT: 'EXPORT';
EXTENDED: 'EXTENDED';
EXTERNAL: 'EXTERNAL';
EXTRACT: 'EXTRACT';
FALSE: 'FALSE';
FETCH: 'FETCH';
FIELDS: 'FIELDS';
FILTER: 'FILTER';
FILEFORMAT: 'FILEFORMAT';
FIRST: 'FIRST';
FOLLOWING: 'FOLLOWING';
FOR: 'FOR';
FOREIGN: 'FOREIGN';
FORMAT: 'FORMAT';
FORMATTED: 'FORMATTED';
FROM: 'FROM';
FULL: 'FULL';
FUNCTION: 'FUNCTION';
FUNCTIONS: 'FUNCTIONS';
GENERATED: 'GENERATED';
GLOBAL: 'GLOBAL';
GRANT: 'GRANT';
GROUP: 'GROUP';
GROUPING: 'GROUPING';
HAVING: 'HAVING';
HOUR: 'HOUR';
HOURS: 'HOURS';
IF: 'IF';
IGNORE: 'IGNORE';
IMPORT: 'IMPORT';
IN: 'IN';
INCLUDE: 'INCLUDE';
INDEX: 'INDEX';
INDEXES: 'INDEXES';
INNER: 'INNER';
INPATH: 'INPATH';
INPUTFORMAT: 'INPUTFORMAT';
INSERT: 'INSERT';
INTERSECT: 'INTERSECT';
INTERVAL: 'INTERVAL';
INTO: 'INTO';
IS: 'IS';
ITEMS: 'ITEMS';
JOIN: 'JOIN';
KEYS: 'KEYS';
LAST: 'LAST';
LATERAL: 'LATERAL';
LAZY: 'LAZY';
LEADING: 'LEADING';
LEFT: 'LEFT';
LIKE: 'LIKE';
ILIKE: 'ILIKE';
LIMIT: 'LIMIT';
LINES: 'LINES';
LIST: 'LIST';
LOAD: 'LOAD';
LOCAL: 'LOCAL';
LOCATION: 'LOCATION';
LOCK: 'LOCK';
LOCKS: 'LOCKS';
LOGICAL: 'LOGICAL';
MACRO: 'MACRO';
MAP: 'MAP';
MATCHED: 'MATCHED';
MERGE: 'MERGE';
MICROSECOND: 'MICROSECOND';
MICROSECONDS: 'MICROSECONDS';
MILLISECOND: 'MILLISECOND';
MILLISECONDS: 'MILLISECONDS';
MINUTE: 'MINUTE';
MINUTES: 'MINUTES';
MONTH: 'MONTH';
MONTHS: 'MONTHS';
MSCK: 'MSCK';
NAMESPACE: 'NAMESPACE';
NAMESPACES: 'NAMESPACES';
NANOSECOND: 'NANOSECOND';
NANOSECONDS: 'NANOSECONDS';
NATURAL: 'NATURAL';
NO: 'NO';
NOT: 'NOT' | '!';
NULL: 'NULL';
NULLS: 'NULLS';
OF: 'OF';
OFFSET: 'OFFSET';
ON: 'ON';
ONLY: 'ONLY';
OPTION: 'OPTION';
OPTIONS: 'OPTIONS';
OR: 'OR';
ORDER: 'ORDER';
OUT: 'OUT';
OUTER: 'OUTER';
OUTPUTFORMAT: 'OUTPUTFORMAT';
OVER: 'OVER';
OVERLAPS: 'OVERLAPS';
OVERLAY: 'OVERLAY';
OVERWRITE: 'OVERWRITE';
PARTITION: 'PARTITION';
PARTITIONED: 'PARTITIONED';
PARTITIONS: 'PARTITIONS';
PERCENTILE_CONT: 'PERCENTILE_CONT';
PERCENTILE_DISC: 'PERCENTILE_DISC';
PERCENTLIT: 'PERCENT';
PIVOT: 'PIVOT';
PLACING: 'PLACING';
POSITION: 'POSITION';
PRECEDING: 'PRECEDING';
PRIMARY: 'PRIMARY';
PRINCIPALS: 'PRINCIPALS';
PROPERTIES: 'PROPERTIES';
PURGE: 'PURGE';
QUARTER: 'QUARTER';
QUERY: 'QUERY';
RANGE: 'RANGE';
RECORDREADER: 'RECORDREADER';
RECORDWRITER: 'RECORDWRITER';
RECOVER: 'RECOVER';
REDUCE: 'REDUCE';
REFERENCES: 'REFERENCES';
REFRESH: 'REFRESH';
RENAME: 'RENAME';
REPAIR: 'REPAIR';
REPEATABLE: 'REPEATABLE';
REPLACE: 'REPLACE';
RESET: 'RESET';
RESPECT: 'RESPECT';
RESTRICT: 'RESTRICT';
REVOKE: 'REVOKE';
RIGHT: 'RIGHT';
RLIKE: 'RLIKE' | 'REGEXP';
ROLE: 'ROLE';
ROLES: 'ROLES';
ROLLBACK: 'ROLLBACK';
ROLLUP: 'ROLLUP';
ROW: 'ROW';
ROWS: 'ROWS';
SECOND: 'SECOND';
SECONDS: 'SECONDS';
SCHEMA: 'SCHEMA';
SCHEMAS: 'SCHEMAS';
SELECT: 'SELECT';
SEMI: 'SEMI';
SEPARATED: 'SEPARATED';
SERDE: 'SERDE';
SERDEPROPERTIES: 'SERDEPROPERTIES';
SESSION_USER: 'SESSION_USER';
SET: 'SET';
SETMINUS: 'MINUS';
SETS: 'SETS';
SHOW: 'SHOW';
SKEWED: 'SKEWED';
SOME: 'SOME';
SORT: 'SORT';
SORTED: 'SORTED';
SOURCE: 'SOURCE';
START: 'START';
STATISTICS: 'STATISTICS';
STORED: 'STORED';
STRATIFY: 'STRATIFY';
STRUCT: 'STRUCT';
SUBSTR: 'SUBSTR';
SUBSTRING: 'SUBSTRING';
SYNC: 'SYNC';
SYSTEM_TIME: 'SYSTEM_TIME';
SYSTEM_VERSION: 'SYSTEM_VERSION';
TABLE: 'TABLE';
TABLES: 'TABLES';
TABLESAMPLE: 'TABLESAMPLE';
TARGET: 'TARGET';
TBLPROPERTIES: 'TBLPROPERTIES';
TEMPORARY: 'TEMPORARY' | 'TEMP';
TERMINATED: 'TERMINATED';
THEN: 'THEN';
TIME: 'TIME';
TIMESTAMP: 'TIMESTAMP';
TIMESTAMPADD: 'TIMESTAMPADD';
TIMESTAMPDIFF: 'TIMESTAMPDIFF';
TO: 'TO';
TOUCH: 'TOUCH';
TRAILING: 'TRAILING';
TRANSACTION: 'TRANSACTION';
TRANSACTIONS: 'TRANSACTIONS';
TRANSFORM: 'TRANSFORM';
TRIM: 'TRIM';
TRUE: 'TRUE';
TRUNCATE: 'TRUNCATE';
TRY_CAST: 'TRY_CAST';
TYPE: 'TYPE';
UNARCHIVE: 'UNARCHIVE';
UNBOUNDED: 'UNBOUNDED';
UNCACHE: 'UNCACHE';
UNION: 'UNION';
UNIQUE: 'UNIQUE';
UNKNOWN: 'UNKNOWN';
UNLOCK: 'UNLOCK';
UNPIVOT: 'UNPIVOT';
UNSET: 'UNSET';
UPDATE: 'UPDATE';
USE: 'USE';
USER: 'USER';
USING: 'USING';
VALUES: 'VALUES';
VERSION: 'VERSION';
VIEW: 'VIEW';
VIEWS: 'VIEWS';
WEEK: 'WEEK';
WEEKS: 'WEEKS';
WHEN: 'WHEN';
WHERE: 'WHERE';
WINDOW: 'WINDOW';
WITH: 'WITH';
WITHIN: 'WITHIN';
YEAR: 'YEAR';
YEARS: 'YEARS';
ZONE: 'ZONE';
